14 15 200 200
OOOOWWWOWWWOOOO
OOOOW3WOW4WOOOO
WWWWWEWWWEWWWWW
WEEEEMEEEMEEEEW
WEEWWEWWWEWWEEW
WWEWWEWWWEWWEWW
OWEEEMEEEMEEEWO
OWEWWEWWWEWWMWO
OWEWWEWWWEWWEWO
OWEEEEEEEEEEEWO
OWWWWMWWWMWWWWO
OOOWEEWWWEEWOOO
OOOWEEEEEECWOOO
OOOWWWWWWWWWOOO