12 12 100 200
WWWWWWWWWWWW
WEEE4EEEEEEW
WEEEEEEEE4EW
WEEEEEEEEEEW
WEEMMEMMEEEW
WEEEMBMEEEEW
WEEMEEEMEEEW
W4EEMBMEEE4W
WEEEEEEEEEEW
WEEEECEEEEEW
WEEEEEEEEEEW
WWWWWWWWWWWW