12 12 100 200
WWWWWWWWWWWW
WEEE4EEEEEEW
WEEEEEEEE4EW
WEEEEEEEEEEW
WEEMMEMMEEEW
WEEEMMMEEEEW
WEEMEEEMEEEW
W4EEMMMEEE4W
WEEEEEEEEEEW
WEEEECEEEEEW
WEEEEEEEEEEW
WWWWWWWWWWWW