16 14 100 200
OOOOOOOOOOWWWW
OOOOOOOWWWWE1W
OOOWWWWWEEWEWW
OWWWWCEEMEWEWO
WWWWWWWWWEEEWO
WEEEEEEEEEEEWO
WEEEE1EEWEEEWO
WWWWEEWEEEEEWO
OOOWWEEEWEEEWO
OOOOWEWEEEEWWO
OOOOWEEEWEEWOO
OOOOWEWEEEEWOO
OOOOWEEEWEEWOO
OOOOWEEEEEEWOO
OOOOWWEEWWWOOO
OOOOOWWWWWOOOO