11 13 200 200
OOOWWWWWWWWWW
OOWWEEEEEEEEW
WWWEEEEEEEEEW
WEEEEEEEEEEEW
WEEEEEEWEEEEW
WEEE2MMWEEEEW
WEEEEEEWCEEEW
WEEE2MMWEEEEW
WEEEEEEEEEEEW
WEEEEEEEEEEEW
WWWWWWWWWWWWW