8 9 100 200
OOWWWWWWW
OWWCEEEEW
WWEMWMWEW
WEEEWEEEW
WEMEWME1W
WEEEWEEEW
WWE4EEEEW
OWWWWWWWW