11 7 100 200
WWWWWWW
WEE1EEW
WEEEEEW
W1ECE1W
WEEEEEW
WEE1EEW
WEEEEEW
WMEBEEW
WEMEMEW
WEEEEEW
WWWWWWW