9 10 100 200
WWWWWWWWWW
WEEEEEEEEW
WMEEWEEEEW
WEWEWEEEEW
WEWMEEEEEW
WEWEEEEEEW
W1W1EEEEEW
WWWCEEEEEW
WWWWWWWWWW