11 10 100 200
WWWWWWWWWW
WEEEEEEEEW
WEEEEEEEEW
WEWEEEWE2W
WEWEEEWEEW
W1WEWEWEEW
WWWMEFWWWW
OWEEMEEEWO
OWEEEEEEWO
OWEEEEC1WO
OWWWWWWWWO