6 9 100 200
WWWWWWWWW
WEEEEEEEW
WECEHEE1W
WEEEEEEEW
WEEEEEE2W
WWWWWWWWW