8 5
WWWWW
WEEEW
WECEW
WEMEW
WEEEW
WE1EW
WEEEW
WWWWW