8 9
OOWWWWWWW
OWWCEEEEW
WWEMWMWEW
WEEEWEEEW
WEMEWME1W
WEEEWEEEW
WWE3EEEEW
OWWWWWWWW