11 7
WWWWWWW
WEE1EEW
WEEEEEW
W1ECE1W
WEEEEEW
WEE1EEW
WEEEEEW
WMEMEEW
WEMEMEW
WEEEEEW
WWWWWWW