6 12
WWWWWOOWWWWW
WEEEWWWWEEEW
WECMEEEEEEEW
WEEEWWWEMEEW
WWWWWW1EEE1W
OOOOOWWWWWWW