16 14
OOOOOOOOOOWWWW
OOOOOOOOOOWE1W
OOOWWWWWWWWEWW
OWWWWCEEMEWEWO
WWWWWWWWWEEEWO
WEEEEEEEEEEEWO
WEEEE1EEWEEEWO
WWWWEEWEEEEEWO
OOOWWEEEWEEEWO
OOOOWEWEEEEWWO
OOOOWEEEWEWWOO
OOOOWEWEEEWOOO
OOOOWEEEWEWOOO
OOOOWEEEEEWOOO
OOOOWWEEWWWOOO
OOOOOWWWWWOOOO