6 13
OOWWWWWWOOOOO
OOWEMEEWOOOOO
WWWEWWEWWWWWW
WEEEEEEEEMECW
W1WEEE2WWWWWW
WWWWWWWWOOOOO