7 13
OOWWWWWWOOOOO
OOWWWEEWOOOOO
OOWEMEEWOOOOO
WWWEWWEWWWWWW
WEEEEEEEEMECW
W1WEEE2WWWWWW
WWWWWWWWOOOOO