9 9
OOWWWWWOO
OOWEEEWOO
OOWECEWOO
OOWEEEWOO
OOWMMMWOO
WWWEEEWWW
WEEEHEEEW
WEEEEEEEW
WWWWWWWWW